R 1000000 10000000

NO textures/n.xpm
SO textures/s.xpm
WE textures/w.xpm
EA textures/e.xpm
S textures/barrel.xpm

F 000, 102,      000
C 255,    204 ,  000

11111111111
1S001000101
10101010101
10101010101
10101010101
10100010001
11111111111
