R 700 500

NO textures/n.xpm
SO textures/s.xpm
WE textures/w.xpm
EA textures/e.xpm
S textures/barrel.xpm

F 000,102,000
C 255,204,000

11111111111
30000000004
30000000004
30000000004
3000S000004
30000000004
30000000004
12222222221