R 600 600

NO textures/n.xpm
SO textures/s.xpm
WE textures/w.xpm
EA textures/e.xpm
S textures/barrel.xpm

F 000, 123, 222
C 000, 222, 123

11111111111
10200200001
10000000001
10000002001
10E00100001
10100002001
10200200001
10000000021
11111111111