R 640 480

F 184,113,39
C 51,198,227

NO textures/wall_1.xpm
SO textures/wall_2.xpm
WE textures/wall_3.xpm
EA textures/floor_1.xpm

S textures/sky_1.xpm


11111
10001
10N01
10001
11111