R 0 0
F textures/plains.xpm
C textures/cloudy.xpm
NO textures/weed_wall.xpm
EA textures/weed_wall.xpm
SO textures/weed_wall.xpm
WE textures/weed_wall.xpm
S textures/cherry_blossom.xpm

11111111111111111111111111111
10000000001100000000000000001
10110000011100000000000010001
10010000000000000000000010001
10110000011100000000000010001
10000000001100000111011110001
11110111111111011100000010001
11110111111111011101010010001
11000000110101011100000010001
10000000000000001100000010001
10000000000000001101010010001
11000000110101000000000000001
11110111110101000000000000001
10000000001100022222000000001
10222220000000022222000000001
1022222000100002222200N000001
10222220001101022222000000001
10000000000100020000000000001
11111111111111111111111111111