R 848 480
F textures/plains.xpm
C textures/cloudy.xpm
NO textures/weed_wall.xpm
EA textures/floor_1.xpm
S textures/cherry_blossom.xpm

11111111111111111111111111111
10000000001100000000000000001
10110000011100000000000010001
10010000000000000000000010001
10110000011100000000000010001
10000000001100000111011110001
11110111111111011100000010001
11110111111111011101010010001
11000000110101011100000010001
10000000000000001100000010001
10000000000000001101010010001
11000000110101000000000000001
11110111110101000000000000001
10000000001100055555000000001
10555550000000055555000000001
1055555000100005555500N000001
10555550001101055555000000001
10000000000100050000000000001
11111111111111111111111111111