R 848 480
F textures/plains.xpm
C textures/cloudy.xpm

NO textures/weed_wall.xpm
SO textures/weed_wall.xpm
WE textures/weed_wall.xpm
EA textures/weed_wall.xpm

S textures/cherry_blossom.xpm

11111111111111111111111111111111111111111
14444444444444444444444444444444444444441
14444444444444444444444444444444444444441
14444444444444444444444444444444444444441
14444444444444444444444444444444444444441
14444444444444444444444444444444444444441
14444444444444444444444444444444444444441
1E000000000000000000000000000000000000001
14444444444444444444044444444444444444441
14444444444444444444044444444444444444441
14444444444444444444044444444444444444441
14444444444444444444044444444444444444441
14444444444444444444044444444444444444441
14444444444444444444044444444444444444441
14444444444444444444044444444444444444441
11111111111111111111111111111111111111111
