R 848 480
F textures/plains.xpm
C textures/cloudy.xpm

NO textures/weed_wall.xpm
SO textures/weed_wall.xpm
WE textures/weed_wall.xpm
EA textures/weed_wall.xpm

S textures/cherry_blossom.xpm

11111111111111111111111111111111111111111
15555555555555555555555555555555555555551
15555555555555555555555555555555555555551
15555555555555555555555555555555555555551
15555555555555555555555555555555555555551
15555555555555555555555555555555555555551
15555555555555555555555555555555555555551
1E000000000000000000000000000000000000001
15555555555555555555055555555555555555551
15555555555555555555055555555555555555551
15555555555555555555055555555555555555551
15555555555555555555055555555555555555551
15555555555555555555055555555555555555551
15555555555555555555055555555555555555551
15555555555555555555055555555555555555551
11111111111111111111111111111111111111111
