R 828 480
F textures/plains.xpm
C textures/cloudy.xpm

NO textures/weed_wall.xpm
SO textures/weed_wall.xpm
WE textures/weed_wall.xpm
EA textures/weed_wall.xpm

S textures/cherry_blossom.xpm

11111111111111111111111111111111111111111
12222222222222222222222222222222222222221
12222222222222222222222222222222222222221
12222222222222222222222222222222222222221
12222222222222222222222222222222222222221
12222222222222222222222222222222222222221
12222222222222222222222222222222222222221
1E000000000000000000000000000000000000001
12222222222222222222022222222222222222221
12222222222222222222022222222222222222221
12222222222222222222022222222222222222221
12222222222222222222022222222222222222221
12222222222222222222022222222222222222221
12222222222222222222022222222222222222221
12222222222222222222022222222222222222221
11111111111111111111111111111111111111111
